kfm: mjk xhd gbp xnk
jmx: sqm lvp sxt hjz
pvd: jkq qsx tsx jbr
hjp: hch rdg rgz hnl
jhp: lsf ljz plt vdx
tsn: xsm pxc cjj khr
sqq: kds brt tjq zfq
drg: rxs hxb lrp tpg
gjh: vss dnz crk bnm
tjq: kll mfq svv jgj sqq
jfn: dxr vfz mfq lpz bbn
xcm: gzf nmj gzm ntv
hms: czj dzv kzs lzl
ntv: ttp xcm pxl xzd
dsx: vtc cch nnx zcp bxd zkv
zxz: pct qkh vbl xcx
sfk: cct xff dgl dfv
vcd: fsj lmn jtz vff ccf
jpp: cxl hvx rdn ftx
tmz: nhg fhk vcl mnn lcq nlx
dbc: mkz npx gvt cbz
qlg: nmj vxn vzr hnl
mvz: shr sgj sms zfj
jrl: qhm tff zvq jbz
jjd: vcl sgj dpk jpk
thb: fbj tgg rjz bbn tvz bgj
nmj: hvp zrz qlg lnc rsf xcm jqr prm
jtd: tlh nnh tmd rqf
ldg: knz kzt vpr pvp
qph: fld lxp mkq xqs
cjs: xql hqz tfk tmx czj
sxr: tlh zzt rtp qlp
srz: zbp zvq jpv mpb
bhx: kpp fht vgs xlh
gvt: bdc btq dbc sdv
kmq: fsj zlt lkf kms
qnb: rrh lsr bpb mcz xnj xnk
jtg: qbs zlp dqm gtp
gkn: mxk ljl qnt mgk gvz
mcg: jgd pkb rkq qlx
nnh: pgp ttk jtd ghf zqd
vfs: kdz mlc thc ctd
xpq: fsj mlb ldr chz
dkb: fxt dmn clc rqf fhq
zrq: gqv btr svh vtt
trr: jtr csd kdd gqh
vmt: rbz ttc nhs ltn
jzp: zlp hsb ckr nhz dpc jpt
pxk: xsr ppq tlz svs cvj
pbd: nxj hhq hsg kbr
dxr: dtb sxt jfn kdz
bdg: lnr qgn hxs bvp npl
qrf: jtr mmv zcp vrj fhq
jlg: rsl pvp xrz lzj
tkh: krk bdb bgg tbm
bgj: vrj rjs dtc thb hbt
zjz: pmq kph fjr msn
nlx: fnp rsp rrc tmz
fqr: dzr lcs thn pmg
nrj: shl hzp llf vdj
csr: jtc tmv rsp cvj ghq
lrz: fbp vtc rkp dtc
xsn: rsq btr xkg txz
jrs: zhj zfd pdc cnx
zjj: nmp jtz pkm zzg
qlx: lvl nzb mcg dcl
cvk: tvl ngq bpp cvv mcn
ltn: xzz lmk vmt qlp
vjv: scd tqs psl dnv
mlf: knk hmd fhx tvz
qjc: rms gzj plx rst
hlz: bqm sqk mpr rrm
fks: rlt svl psl lrr
tkd: hlp jcc kqz xnq
clm: ndb pcv zqc sdj
xxn: rms fqt rjt cgz
tmx: hlp cjs lqs jph kzm
cpc: fst skm clg zsr
mcn: hlh sqp scd gkh cvk pmj
qcn: fqm vrj xpl qcx
jqh: vhs zfd bfp hch
fxz: jdj hfz fvh qzl vhs
bms: hzp tdk xzg nqp
hjz: gpt tps sbk clc jmx npq jjn
zqz: rtr gfs rkq tfs
qnq: ckl mql vtn smn
tlh: sxr xpb jtd lmd nrd
rpv: xtj nhz jcb tjr
xnq: spn rmr tkd drb
rsf: kgm nmj nzn vxm
btn: lhz cbx vqc ntf vxm
cmz: lgx xpx gtr cxm kvq srb vtr
rkp: lrz blg jgj fqt mzm
qtv: zkm xzv kcp vdj
qbb: lnr vnt jmg gkh
jfd: fvb fjx nbj hqv
kgm: gbp dxn rsf jgd vjx
lrp: qvv drg xhv bmd
vhx: bfv sss jcb ccj
gxl: vhz mkh hbp xsh
pml: tsj fnn zmd jbz
fhs: xlh bft bfv kzr hgj
zrp: bpn kkl jxs rdj msp
ttp: ntv tks vgh tbl
dnz: knx sdg gjh hgj
rch: mdh lmn vqn fht
bgh: ctn fsn mbj jbz
ccc: cmk kdq npp dxn jnj
skm: rjt cpc shl npx
fvf: rfb pvz srb jqd
jhv: nts xbd fst smf nrt
bzp: knz dzr mvh hmk
hpf: jrf lcj vtc nzk
plx: nph nrt qjc btr
ttq: ctn xvs dvq hmr xrj
jln: vst fbr hvx ldp jpk
frj: slx qsx nzx ljl
vmm: jcd xzz hml rrc
sdp: hhl scj bpn xvh rrm rdb kms
fzj: rjs fbr tns kcc kmj
pkm: zjj rll fbl fvg dzr nzb fns
pzn: dqd qbp rst grv
fnr: sqp lzc jns tlx ghq
ptl: jqm kkr sdb mmv
vtc: lrz hpf tzz dsx
rzd: mbj rtg nnk dlb
xtr: lpm dqm hcz rfb
vth: nnx mdc kdz sbx fbj
jfz: rcz fbq ckh qrd
mgk: cch gkn xkg vkt
dmf: ngq gvk zkk rsm
ztg: plz hjt blr htk hqd dzv
lkf: mjk gdh tgt kmq
pln: qrj vjx dlb jqb
lpj: svl tdl scd ptj
qjn: jcv dqm ftm jbz
bpp: drf cvk gcp bjj
jck: pgp mql bkv hxk txc
xtj: knx rpv msb ctn pmg
zqt: plh hnn hfx fqh cvv
tqs: zrj vjv jdq stv
czh: pzl xrg scj hcm
rdb: mpn dvr tvg sdp
nhc: cdm bpj jqd lgx
zbg: zvp mfq hjm khc
dzr: fqr pkm bzp gcq
hxp: nbt pmg tbm lsr
jml: rtf pvc zls npt zzk tpc
zms: tgt hbc kkl fsn
cxm: ldr ghp cmz lkr
bqm: xgs gdx bql hlz
zdl: jqm zfs qmk fqm
rdf: qxn mql cdb vqh
sqk: kdq xnr lmz hlz
khc: lbn hdg nms hdn zbg
fnn: sjv hjt ltm pml
tdg: dkf mnn vcb tvd
hvx: jln jpp fdq jft
jtr: qrf trr gtb ljs xbj
pbq: hhq xvb xrh phr
bgz: srm khk ldq ncz
hzp: bms nrj vpj gdd jjn
fvh: rrh fxz rnn lnc gqn
psl: sjb fks vjv hkl
clc: jhl tcz hjz dkb
vdj: vhv xxv qtv nrj clg
pnx: svp lgz tdt vqn mvh
stv: jft gkl fkm tqs dsk
lpp: mrz jct ggz vcb
tbl: fsn jqr qbg nlf ttp
krk: tkh dtf xqn nlf lgb
dsk: jbh bhl mrb stv
lvf: gsb skx mzc szh
bhm: rcz fvg bsn hch mdg
rhk: ghq shm rft rjx
krs: jkp gtr rzl nlf
xlp: gkz tvg kvq zxf kft cxg nzb
lfl: jkr glj ccf djr
qnc: zrj zkk tkp mds
ghp: cxm lkc hqr grq vpv jsl
qzl: nmq qzg fxz cdk bgg
nnx: cnc pkf hsg dsx vth
sdm: llk kgq smn xxk
bdt: kgd xzd xdc chx kzs
qmq: ljj bft lxb kms
bbh: ljj mpn jvp jnd
ckh: jfz msn zxv kms
xmt: vdx hsq llk ngh mpd
npt: jml kvg rpm rsl
hlv: bfl vpr czg bgs
xhz: zjf zkm sbk lvv
fbm: jlt ptj hmd rrc
fqv: fhk fkt gqv mpd llk hlh
mvd: rfb chx jqz pzf
ccr: qfr shr qgn ztk tqv
czs: vjc tdk drr mtz
mkd: lmd rjz vjs ftx
jcd: ftd jdq vmm blg kvl
tdt: knj sdg nkr cgn hqh pnx cff
mns: sdn ztx gsd jpg
bkv: xzv jck hfr bsg
tfk: dxp tfs pgr qxv cjs
pvp: nmp jlg xfv ldg hnl
ctn: xtj zxf ttq bgh jcb
llf: lbn kdf nrj tnv pmn
sml: jtz hpq bkt pjf kbj
xlh: fhs hlr zlb bhx
ptj: smn svs tlp fbm bmv lpj qlp
lrr: bvp fks kzn grv
vll: mzt hfr tvl hdg
vst: xqv jln kdf pdd
lcs: pdc rkq fqr zpg
mpr: rdg hlz dtp jph
pmj: knk bsh smf mcn
jpv: dbx bfl srz txg
cct: lsm nnk bmz sfk dpc
qxt: tfq thm zsr nxn
lhx: zps mxs fkl bgs
xhx: tsf zfd rhx txg lsm crv
qmb: vjx qll mpl fsj
jxg: hsb gqn hmh hrr rbs
jpg: tvz vfp srm qxq mns cqd
cxl: jpp tms csd pjn
knz: ldg qbs bzp pcv
fxm: dhr vnk rzn fxt
jrz: qts hdm vgl rll
kzj: lsm chx tfs jxs
kzr: mdh kdq skk fhs
pgp: zcf jck nnh ltz
sld: mfq rdn tmv pjk
mfq: sld tjq vmg zbg jfn rkv fhx
gkz: xlp xql dqm qbg zbp
sbx: nxn bhv svs vth
rck: jld tzn fkr xqf
mpn: mtj bbh rdb bkm
mts: dqm qld btk sxf
bfr: hcc rpt tjc kdd
fgd: vnt nzk mql gpt
hnh: rfm sdg pjd cff
ntb: fhv tqf qvv glk
kgn: bdc qsh vfq grv
ndz: rmp bfx zqc lpd
mqr: tlx nzx fst vdx
cdc: thm sdf svv xbj
cbx: btn ndn nlh rpm
zcx: pmn zgb nxp rbn
vkf: xnd qzj jxs zmd
vcz: dsn vjd vdh hsp
knn: xkg khk mmv tgv
ljm: jqd ndh vls zxj
dlv: lvb vbv qfr kkr
qrj: fbl ggh fjx mlb pln
xzz: vmm tvd ltn btl
bjz: tps slx nzk vtn
lmr: shm rkh ftd glg
jlk: pvt nrd tbx kdz
mbj: rzd bgh bpb bkz zpg pkb
sgj: rjs jjd knv mvz
lxp: jqc qph fsn sjv
vqh: mql tsx rnl ltb rdf
lqs: lkr rnz tmx lpd czj
lbl: skk vhs dqh hnl
ndb: clm ghg pqt dxm jvq
dkf: pmn lpz tdg qpz
vls: mdg drc ljm xsh
mgx: rrn zqj vkb pjn
ghq: rhk jjh fnr csr
pkb: qbs mcg mbj scj
gdg: bbl ktb tns rkv
vkx: ftr czg vzr bgg
dgt: hzf kdf tdl rpt
pxc: qtx qxn tsn hpr
kvg: npt fbq vnf hrh
vmf: xqt xbv jch kcc rzh
vjx: qmb pln hvp kgm
xmq: ssk gkq lpd djr
rkq: lcs zqz vxn mcg lbp
nqp: bms gpt cpl tzh
kmf: thp xrm kbl slb tbx
hch: jqh tsj hjp xqn bhm btk
vjq: rxs jgd jxv rxc
vgs: zhj bhx bsc jtk
xjf: lsr dtp gts dlr
qng: rnn nzb dcn zcv
ftv: kgq vfz pbx lcq gkl
tzk: qhh tff cfr tcm
rrc: mqp kpd vmm fbm nlx
mmp: rhx nmp tqf jxs vtr
xnz: xqf qnt fpg vnk
fjr: zjz jmk tbm ghs
cgn: lhf lpm tdt crv
pzl: nmm llq hqd czh msp txm
vjs: ttk nhs tlp mkd
rzz: zts tmv pzk lnr vnj
mrm: zpr rxc ltm snt
rzq: xnd dsn hhl ccj
zrc: jdl rtr lvs pqs tsf
tth: pqc ndl xcx zvp sdf xrh
pkz: pqx nlh fns kvh
shr: ccr tgv kbc mvz
gcq: rrh bdb vzr dzr
jqb: rtf sgt spk pln
mlb: qrj xpq xmm hqr rrm jtp lxb
mvg: tdm zrj kkr tjc
kgd: bdt jhd jqr pvz
rmr: xnq cdk ltm bkm mdg
lzg: jgn pdd knk vxv
kkr: ptl fqd hbt mvg dlv
glg: ngh xxm lmr tkp
zcg: czg mtz mtj vdh
lzc: ktb vzb gcj fnr
npp: xvs sss ccc hdm
rrm: vfk kgj gbt snt hlz sdp mlb
dxt: cbj vnp nxl hqh
fqd: nkn xgh bfh kkr
mkq: sgt qph ckp ndh
hmd: mlf qnd fbm xkn
pqs: vjd jcv ckr zrc
ncz: bgz vrv mql pvt ttc
gqz: mqh zfd hmb pfr
lgx: cmz lpm tqf nhc qzg
rbz: lcj qbl vmt lmq npg
qsh: hlc kcc gcm krq kgn grv
scd: sls vjv mcn rhb lpj
zhv: vlz gtb hlh qbp
fgn: ccb lfq rlt rdn hfd
nph: plx tns lrn zvl
hsp: zps vcz sdg sdj
mqh: jqd msb jhd gqz
dhr: fxm hvg gcp mjj
rlh: hxb zds jqd xvs
blr: rfj mdb dtp ztg
sdv: gvt dtr slb mlv
vlz: kdd zhv gfj hcd tbq
xxv: vdj jbh hsg fxt fhq
rtf: rxs dxm jqb ngp jml
tvg: mjk xlp rdb fnb hbc
xkg: knn xsn thm mgk
rft: pqf cxn vhv rhk jsx
zxj: ckr drb ljm sss
mnn: lvh tdg tmz mzm
ncf: plz xfz bpb nlf ccj
rfv: bkm vpv dqg kqz
qbs: pdc jtg pkb cgs knz
pcv: knz dvl clm cxv
ljz: njf kgb ktb jhp
ckn: jgn tpm jld xzg
vgl: vnf ftm lxz jrz rrj
pvz: kgd rzl xlt jph fvf
kvl: nvl rfc rsp jcd
cdm: jbx nhc bfx zpr pnn
xmr: dbx dlk dnb lkd
bft: zbp qmq fhs mgt jnj
dgl: lgz lln zxl qpd sfk pvc
hqh: tdt dxt chz nsq
pgr: tfk llq xff xrg
ddj: jmk fkv gbz chx
pmq: nrg zjz mtj rmq
lpz: kll dtb jfn dkf pbx
lnr: qbb bdg gjf rzz
zpb: rgz pmg tks drb
scj: sdp czh zsp pkb
lvs: bsc zrc bkt rtg
xdc: bdt pzx bmd rpm
nms: bqs khn jmg khc kgc tls
xsr: pxk vlx kgb mgv hhz rzh pdd
fbl: qrj vpr jnj pzf pkm
zfj: ngh pkf mzt mvz
brt: khk mlv sqq rjx
hld: clg sbk cbb vkb
prc: kds tbq gmv qlp
jmg: rfn bvp nms qbb
bfp: jqh ckr jcl nsq
hsg: ngk pbd qqr nnx xxv
fkf: mjk tft hcm sss
crv: vss xhx kph vff cgn fsn qhp xfv
bgg: vvx vkx qzl lsm lvk tkh bkt
xfz: kgg czc ncf hmk zcv
zqj: mgx thp jks svh
rrj: vgl nkr lkd vzr
hjt: ztg qzv bvl fnn
llk: cnc sdm vfq tdm xmt fqv
gbz: hqv tsj ddj vjf
pjk: sld ctd bhv kvn
tdl: lpj lfq dgt qqs
kmm: glj pxg hlp hgz
jhq: qrl qpg tdk gvz
hdn: tdm tvl tnv khc
zjf: xhz ngk qpz jqm
ckp: dnb jnd mkq kht
qgm: zzg xnb hfc txk zcv
bqb: mjr tgb skx cqd tls
kmz: rxs lvk qxv bmz
nrz: sgt kvh lds kms
dtr: tlx mxk bzc dbg sdv
kkj: kxn prm pqt lnc
zbp: gkz pzf bft srz
gzj: qjc sdn kng zxt
qll: qmb sgk pnn zxl
pxf: kkf ftr rmq nsq
tpm: tns ckn trp kgb bfh hvg
cfr: nfr lds dpv tzk
npl: bdg crc tvd mzl
qbg: gkz xhd nkr tbl
bdb: gcq tkh sbl dhg
crc: nrt xmf dpk bbq npl bsg
qxv: tfk kmz mkh chz
rtr: dcd zqz zrc cff
rdg: hfz dkp hjp mpr cdl
pcl: hgt hxh kgc krq bsb
tqm: lnc hmr bgb jbp
lbn: llf khc ccb sqm
rkv: svl gdg mfq hkl
dvr: zlh glj xvh rdb xrj
zlp: lpm jtg xvj jzp sjd jsh lpd
dpk: crc kdf lnp jjd
glk: zlt kgj ntb dzv
gjf: lnr tgg lvv vnk
zps: qhf lhx dxn hsp
hdp: mql dkd lfq xjr
kzs: hms jtk pxg bdt
nzx: plj ncg mqr tgb frj
pst: fpg qpg kbc ggp
hzf: jlt tzz mvn dgt xbr
jcb: xff vhx ctn rpv
hbp: gxl dvq pqt vqn
xnr: txg zds sqk tpc qrd
rhb: gsb xsm scd qjb
fzk: zfs zts vqv jxt
ndh: bbg qzx mkq kvq ljm
zvt: nlr xxm fpg ngm
chx: kzj ddj mvd kbj bdt
fnl: qzk dvd xjg xgz kzt fpz
tsf: xhx dcn skk zrc
jgf: cnz tjr qzj mpl mxs
mnv: lmk lvb knv kmr
bgs: lvl txm hlv lhx rjg
jdj: fxz sxf lfp pjd
xgh: fjt fqd qqs zhl
pzk: fjt vmd rzz dxh
ssb: vxn lzj mhr lgb
jsl: kts dkp ghp gbt
jtc: drf csr fzx plj
zfd: jqh xhx jrs jzx gqz
gtr: gbp knj vvc krs cmz
vnt: jct fgd qbb svl
jbh: xcx dsk xxv kmr
btq: mvn jch cqt gvt
qld: xnd ndn mts rvv
ndn: lfh rss qld cbx gzv
tgv: hgr knn shr phr
kcp: qtv thc zkm ghf
xfv: xql pvp rgz crv
tgb: svs nzx bqb knv
tzz: vtc hzf pdd jsx
vbv: bqs rbr qpg zts vfq vfp dlv
sjb: psl mjm qbl tfq ljd
czc: fvb fpz kgg xfz
lzl: hms bfx ljj xgz
hfx: rbr zqt fkr mkz
hsb: zsp jzp tqn jqz jxg
tcz: zhl xqt clc sls
lzp: rpt vgx mkz dts
cvn: dbx jtl jtk bkz
jqr: nfs tbl kgd nmj
plt: mnh fdq xbv jhp ftx
lpm: cgn hrh zlp xtr lgx
ftd: jcd tjc tsx lmr xzg qfg
pqt: ndb vgh hbp kkj vtk
ttk: vfd kmr vmv nnh vjs
xnj: hpq qnb dpv qhh
xvs: npp ttq xpx rlh tqp
xzv: lxc bkv qtv xlz
fjt: npz xgh pzk tzh
krf: dtb nxj tnv lvb bsh
bhv: sbx ckl pjk knv
dbg: fbp bhl hfr dtr
fst: cpc jhv mqr ftx
spk: mrc jqb drr zpr
kjj: xlb kpd svv vmd dvs
npj: fnp vtn dts hgt
ngq: cvk dmf xrm kmj
dnh: vpv qsm zds hqv
zcv: lfh xfz qng jjf qgm
vhs: jqh fkx lbl fxz
tks: nvp jth ttp rss zpb
jxj: xrg zxl pgz hdz dlr
xxm: ngm qrl glg zvt
xvh: dvr sdp rsl lmz
rbn: lvb qsx zcx kdf
xpb: tlh thx fbr bbn
jch: kzn vmf fzx btq jbr
xpx: zlb jph kxz xvs cmz
fsn: hmh tbl lxp bgh zms crv dvl
gvd: cdz hqd ccj jvq qkb
vdx: tvl mqr xmt jhp
smn: ptj sdm kpd qnq
mpd: xmt fqv dmc tvl fkt
ncd: nts tms bxd mrb vlx
mjm: sjb ppq vhv msg
qts: jrz jkp hgj fnb tqn
jsm: rsm ndf gvn zrj hcc
bkz: mbj xlt cvn sgk dqh
rsp: ggp xhk csr kvl nlx
dch: fsj ffz lzj cdl
gbp: kgm gtr kfm jdp
tdk: jhq czs bms nxj mvn
rzn: xqj gtb gmv fxm
kdd: trr vlz drf bfr
skk: hmb kzr tsf lfp lbl pjf
pnn: qll cdm dbx dlk
jtz: sml ltm zjj kft vcd
xsm: rhb tsn pjn qdf
mjj: xxk dhr hcc srm
lxc: cvj bsb xrh xzv zfk
dvq: ggf hbp ttq bfv
ppq: ltz mjm xmf hnn pxk gcp gkh
rcx: vtr nxz vpr kgj rfb ztr ghg
qlp: prc ptj ltn sxr
vpj: qmk hzp hml hbt
prt: jhd zvq ftm mxs
xqs: dbx mrc hpq jkr sbl qph qkb
mlc: rfc qxn vfs hxs bfh
hlr: xlh jkr pzf vkz
rjz: mkd xbd jxt thb
pqx: xdj nmq pkz kch tpg
tqn: rmp dsn hsb nhz qts
bmd: gbn xdc crk lrp
zkm: qtv djh kcp xhz
pqc: tth lcj vfz xhk cqd
sdn: qnd ctx fqh mns gzj
xbv: vmf jjh lzr plt
nxp: cpg hlc zcx ltb
qsd: tzm qjb hxs zzl vtn
cxg: kgg nbj xlp cdl kzm
hsq: xmt qpz mzl nzr npq gkl
vhz: gxl hmr dqh cxv
khn: nms xxk bfj cqt
kxt: xqv vfz ztj txz
jjc: kxn zxf kbj ccj
bpj: nhc rfb cnz cgt
lcj: hpf rbz pqc qqv
vfk: rhx znh rrm xjg
fns: pkz ssj rnz pkm
fvg: pkm bhm fkl vxm
zsr: mqp qxt ttc cpc npg
hdz: rfm vqc jxj sln cnx
rrn: djh mgx tkp vnk
ltz: pgp ppq thx gsd
dqg: xnv hfc rfv bnm fkb
ghh: vmd blg rkh lsf
qkg: vvx grq kqz kxz
fld: qhp btk qph jtl pzh
mdb: blr lfh sjd lsr
kmr: ttk xqf mnv jbh
pzx: xnd kdq xdc xkj
dzv: hms ztg sln xnk glk
lmk: jjh fbj mnv ltn
qvv: lrp hpq sgb mvh ntb
lkr: vxl lqs cxm kxn
mkh: gxl pnp gts qhf qxv
rjt: mds xxn xkd skm
prj: nmm jth czg jnj
ldq: jns fqm bgz gcj
rqf: sqr jtd dkb qbl
pzh: vzr rjm gtp fld
mdg: vls rmr bhm qzx jfl
npz: cdj fjt jhl nfn
gtb: jtr rzn vzb zhv
srm: jpg vfp bgz mjj rfn
dxp: tfk cnz zmd vvq
slb: bvx sdv gvn kmf
jmk: fjr cdz lln ddj fzm
tzh: fjt tqj nts qkh pqf nqp
hvp: nmj vjx ktf ftm
bfl: xhd djr kph hlv jpv zpg
mhr: ntz lrc ssb htk
pxg: mtj mcz kmm kzs
ckr: gmm jzp zxj bfp pqs
qgn: bdg ccr vgx vcb
lsf: svv jhp jks hdg ghh
hqr: cgt mlb bvl ghp
gcp: dhr ppq vcl bpp
jxv: fdf ggf rfj vjq lln
hhl: sdp hbc qpd rzq
vxl: gfs lkr vzr qhp
vlt: xlz shl kgb rdn
zrz: rtg nmj mcz xkj
tlp: cxn xbj zzt ptj vjs
zgr: csd nxj qmk rfn
nzk: fgd hpf qmk zkk bjz
xch: tgg zqd npg qqv
dnb: cdl ckp fvz xmr
zcp: qrf dsx vqv bct qrl
vjf: kvq vff gbz hbc
xkd: rjt bjg thm jld
zvq: qvj srz jrl prt
phr: kbl tgv xbj pbq
rrh: fvh kzt gcq dfv qnb
hlp: tmx kmm gfq tkd
bvp: bdg jmg qpz lrr
rxc: zhj nrg vjq hmh lrc mrm
kvn: ztj pct trd pjk fqm
cxn: tlp rft psx fqt
hqz: dvd ftr mmc cjs
pjn: cxl qnt xsm mgx
cdj: npz ccb qfr kjd
zsx: dcd xzm sjd vjd kph
gts: tgt xmm mkh xjf
vtr: rcx nbt cmz mmp
gcj: ldq lzc sfg vkb
xrt: rdn zfk rkh rst plh
hgt: qbl vlx pcl npj
kgq: psx ftv lvh sdm
cfd: gmm sdg jtp gzm
xqn: gzm jcl hch krk tft
cbj: nfr dxt cff zqc
mzl: hsq drf npl nvl
cdz: kdq gvd jmk txm
knj: gtr svp tdt nxz qps
fbq: fdp jfz llq kvg zls msp
fbj: lmk npg vth thb
dqd: ggp qcl pzn svh
rxs: drg rtf kmz vjq
vpv: rfv dnh fkb ghp
tqf: mmp lgx ntb qkb
xjq: bdk khk rzh hlc
vhv: ggp rft mjm vdj
qcx: qbx gvz qcn bmv
thc: tgg xbd vfs flb kcp
nhs: lmd vjs kll vmt
plz: ztg zlb ncf jbx
ckl: qfr tzn bhv qnq
svh: pdk jlt zrq dqd sqr zqj qxq xlz
tsj: hch pml xrj gbz
nxz: zzp knj rcx bsc
djr: bfl rzl xmq lfl
njf: ljz ctd ztj nkn
jdq: jcd lvh tqs hxk tzn
rbs: snt ngp zsp jxg
nzn: jdl bbg rsf kkf lmj
gvn: jsm svs jqx slb
hqd: gvd pzl ntf ztg
sss: npp vhx fkf hcm zxj
ktb: gdg ljz ggz lzc cjj
fbp: lrz tvd dbg pgs
cgs: qbs kvv vkz gdh
lfq: qfg fgn tdl qkx hdp
tgt: lkf gts zms tqp
tpg: pqx pgz drg zxv
fkx: vhs zzk hcm xgz nsq
vrj: npq zzt qrf bgj qcn
bvx: xbj vmg tzm slb bdk
fsj: dch vcd kmq xpq qmb
nts: xrm ncd jhv tzh
vqn: rch pnx ghs hbp gzv xsh
zxv: gtp vnf ckh tpg
bdk: xjq ctx bvx xbr
ftm: qjn vgl prt hvp
tps: bjz hjz vmd fkr
xxk: khn mjj qpz sdm
pdk: svh rnl dxh hxk
mrc: spk xqs gvg gkq
hxh: jrf pmn pcl tqj
ssj: kkf lkc fns msp
jnd: kgj cxv ckp dzd fkb bbh
hgr: tgv trq zfn bkh
rfc: mlc lmq ctx kvl
vnj: vrv knk cbs jbs rms rzz gqh
thn: cmk kpp jpt fqr
bjj: qbx csd qdf szj bpp vvp
vzr: vkx vxl gcq qlg pzh rrj
vkb: gcj mgx tlx hld
fnp: mjr npj cdb qkh nzr nlx
mgt: kpp xlt bft nfr pjf
cch: mgk rlt pqf dsx
zfs: zdl qxq fzk kmj
xnb: qgm vkz crk vvq
ltb: nxp flb vxv kbc vqh
lsm: kzj cct xhx ztr bgg
kll: lpz hpr tjq nhs
mxk: gkn dtr hlc dtc
tvl: cvk hdn vdx vll mpd
kmj: zfs ngq gdd fzj
zpg: lcs bfl mbj mmf lxn
kvh: nrz hmk gmm pkz
hml: jgn vmm pqr vpj
ngp: rtf bql gmm rbs
ndf: jsm zgb tns qsx
fkv: txk ddj xvj gfq
slx: bjz frj dtb hdg
nxj: pbd tdk krf gkj zgr
rss: dlk vgh ndn tks
svs: gvn sbx tgb pxk ptj qtx
hpq: qvv xqs sml xnj
npq: vrj hsq hjz njd
tzm: bfh vmv pnd qsd hnn bvx
vkt: kbr gvk mgk zvp
qrd: jfz rjm jfl mkn xnr jcl
qqs: btl xqj gsb xgh tdl
zds: dsn xnr dnh rdj rlh
xqv: kxt vst npx hfd
njd: dkd txz bsh npq zzl gqv trp
ljd: fzx jns sjb dkd
fnb: mmf tvg qts vtk
dkp: qps rdg ggh jsl
xqj: rzn ztx qqs tvz
bbl: gdg tlz vzb ldp xvb
kdf: dpk dgt vst fkm llf rbn
lln: brb jxv jmk dgl
qfr: vbl ccr cdj ckl sjg krq cbz dlv
qqr: hsg tlz jjh ctd hcd
qqv: xpl hvg lcj xch
xrz: nvp pfr pjd gvg lmf jlg
lkd: dtf mpb rrj xmr
kvv: tjr flr pfr cgs
jtk: lkc vgs cvn kzs
gkh: mcn cnc sls ppq qbb
xnd: vkf rzq pzx gqn qld
vfp: jpg srm jld zkv vbv
sfg: svv cbs bfj gcj
txk: qgm ssk fkv mpb qzg mmc
xzd: ntv bdt lvk xzm
vff: xvj vcd crv vjf
dhg: kqz vtk bdb sjv cnx
ztj: kvn mnh njf bbn dtc kxt hkl
npx: xqv dbc skm sms
lhz: spn qzk btn lxn
crk: gjh xnb jvp bmd
qsm: dnh gtq dcn gvg
vtk: dhg fnb rnz pqt
xhd: bfl kfm jzx qbg
gdx: bqm pmg vxm kzm
hcc: zxt bfr skx jsm mjj
jqx: qjb nfn blg gvn
bfv: dvq kzt vhx fhs
fdq: pqr plt hvx xrh
mcz: pxg kft zrz qnb hrh
fqh: sdn kng zqt xvb pkf
mnh: plt ztj bhl trd jpk zfn
csd: zgr trr cxl bjj hkl
kgj: bsn jnd glk rrm rcx
jpk: jln mnh jjd rbr
gvz: qcx gkn vhl jhq
bqs: rkh nms nlr vbv
sxf: jdj mts dpv nbt
blg: rkp jcd ghh sbk jqx
nrt: crc jhv rsq plx
tcd: plj zcs hbt mds
sbk: blg dtb hld xhz hjz
grv: trd kgn qsh lrr pzn
cff: hnh tdt rtr cbj
cqt: khn pct btq dcq dmc
sxt: dxr szj qfg ljs jmx gqv
dkd: njd fhk hdp ljd
hnn: ppq zqt tzm fbr
zts: jjh rzz fzk vbv
tqv: xzg ccr smf lmm
qjb: jqx qsd zfq rhb ljl sqc
gcm: mzc qsh msg nvl
tpc: vlh xnr jml jtp
qhp: fld vxl crv lmf
bmz: kxn cct kmz czj
jrf: xcx hxh bct hpf bjg xjr
pjf: kft rdj mgt sml skk
bhl: mnh rfn mlv dsk dbg
jjn: nfn zkv tls hzp hjz
kms: nbt sdp nrz kmq cmk qmq ckh
lmn: sjd vcd rch dtf sbl
mmf: vjc fzm zpg fnb
sgk: qll dzd pgz bkz
bxd: cpl dsx lvv ncd
tls: bqb nms jks jjn
zls: jpt jml mpl fbq
jkr: xnv hlr xqs lfl
bbn: tdm ztj jfn thb xpb
rms: qjc xxn zrj vnj
hmb: jnj skk zzg drr gqz
mjr: mrz fnp sdb bqb
kdz: tlx dxr vfs vth vvp jlk
clg: cpc hld pmn vdj
zkv: fhk jjn dsx vfp
tqj: vcb hxh lzr tzh
dtf: lkd lmn cbt krk
hfc: dqg bql qgm fhv
nnk: bkm rzd cct btk kxz
fhx: mlf sqr mfq flb
vkz: hlr xnb cgs cbt
pnp: nmm mkh jxf jqd
djn: hfz rnz gvg lmj gkq
vrv: vnj lzr ncz zfq
dtb: dxr krf lpz sbk slx rtp ztk
jgd: kgm ktf vjq mcg lxz
fkl: ggf rdj lhx fvg
lvb: krf mnv rbn dlv
jxt: jgn rjz xlb fzk
knk: szh mlf pmj lzg vnj
fqm: sqp ldq zdl kvn qcn
hdm: hrr jrz npp pmg
dbs: qrl sdb bsg rnl
nnc: ngk szj xqf hbt
vnk: xnz rrn gjf fxm zhl bkh
dpv: xnj jvp sxf cfr
svl: lpj vnt cgz fks rkv
ghs: jtl lmz fjr vqn
vgh: rss lhf pqt ttp
cxv: hfz pcv vhz jnd
hqv: gbz dnh lfp jfd qzv
xrm: nts bzc kmf nzr ngq btr
trd: nmr bzc grv kvn mnh qkh
jdp: hjn rjm gbp cbt
hdg: lsf slx vll khc
zzg: qgm hmb rhx zjj pmg
fpz: czc dlb ccj fnl
hfz: djn cxv fxz rdg
lzr: vrv qkx xbv tqj
jpt: jqz zls thn jzp kht
bsg: crc bkv dbs vvp
knv: sgj bmv mnv bhv bdc tgb
kts: jsl mtj rnn qhf
jtp: tpc mlb tff sjv cfd
qbl: hgt sjb rbz rqf cbz
bkh: sdb vxv hgr vnk
xvb: pbq fqh bbl gfj
lvh: kgq sms mnn jdq tfq
tvd: xzz fbp npl tdg
mql: vqh fgd rdf jck hdp ncz qnq
xff: sfk pgr lrc jcb
vvp: rjx bjj bsg kdz
xdj: knx fvz pqx mmc
dsn: vcz tqn zds rzq
qrl: jhq dbs xxm zcp
lmq: ngm nxn rfc rbz
jzv: qhm tbm cdk bpb
kbc: pst sjg ltb cjj shr
hfd: zzl rsq xqv fgn
vpr: fbl ldg rcx hlv
lxn: lhz hgz zpg rjg
rbr: vbv hfx dkj jpk
dkj: rbr hjm pnd jgj
xlt: mgt pvz dlb bkz
nlh: jjf cbx pkz jbp
rzh: xjq vmf qtx xsr
qjp: zqc hng kqz ztr
gbn: rmp bmd zzk qvj vss
jjf: mjk nlh cdg ffz zcv
kdq: kzr sqk cdz pzx ccc
shl: vfq vlt skm nrj pdd
sln: mdh tfs hdz dzv
hnl: lbl hjp qlg jvq pvp
cbb: qbx qpg hld sjg
vtt: nhg zrq pbx fht
tff: tzk lds jrl jtp
nlr: bqs zrj zvt jks
mdc: vth nmr kbl trp lrn
xsh: bql gxl vls vqn
nxn: sbx lmq djh qxt
cpl: nqp shm lmm bxd
lfp: skk msn hqv jdj
cmk: ccc nfs thn gxf kms
drr: spk czs pmg hmb
tfq: qxt vhl sjb lvh qtx
sdb: bkh dbs ptl mjr
xmf: crc ppq msg ctx
xkj: pzx lgb vjd zrz
zxl: qll jxj dgl jcc
bpb: mbj ncf qnb jzv
zhl: xgh vnk tcz cbs
brb: jth gqn lln kht
xgz: fkx lgz lzl fnl
xnk: hcz kch qnb kfm dzv
bct: jrf dnv qdf zcp
vnf: vgl lhf zxv kvg
mzm: mnn dmn rkp ndl
tgg: xch thc gjf thb
kjd: vmg zcs cdj kng
rnn: fvh kts lds qng
flb: thc ltb zzl fhx
shm: lmr rhk zxt cpl
lmz: sqk vnp xvh ghs
pmn: dkf clg hxh llf zcx
nbj: cxg ntf jfd khz
dbx: jpv xmr xqs cvn pnn
sgt: nrz jqb bvl mkq
mtj: pmq pxg mpn kts pfr zcg
tqp: tgt gzf xvs lhf
xjr: bbq jrf fxt hdp
ccf: jfl lfl vcd lmg
vfd: rst hxk ttk qbp
sls: scd gkh tcz hcd
xpl: npg qqv bdc qcn
fvz: xdj dnb hgz ljj
nrg: rfm pmq gzv rxc spn dcn tcm
txg: xhx xnr jpv xrj
zzt: tlp vbl sxr kds cgr vrj
gfs: zqz qvj hrr vxl
ftx: jpp mkd plt zvp fst kgb
mzt: vll plh hlh ttc zfj
tmv: sld sqc zfk rzz csr
krq: thm pcl qfr qsh
nlf: tbl ncf krs krk
hxs: bdg mlc qsd zfn
cgt: zhj hqr fht bpj
dcd: rtr lds zsx cnd
rfm: nrg nsq hdz hnh
tkp: rrn qbx sqp rjx glg qnc
czj: hms bmz lqs cjs
fzx: jch kng ljd jtc
kbj: lhf jjc chx lmh sml
ctd: njf vfs qqr pjk
ggz: ktb jns lpp tsx
npg: rbz xch fbj xpl zsr
txc: tns zcf jck ncg
msp: zrp fbq ntf ssj pzl
qvj: gbn qzv zvq gfs kht
ggh: qrj dkp jqd tft
gfj: sqm vlz xvb trp
jks: lsf zqj tls nlr
gsd: pkf mns rnl ltz
lds: dcd nrz tff cfr rnn
vdh: vcz lzj prm zcg
fzm: mmf pxl jmk bpn
qzx: kkf ndh mdg vjd
mrb: cdb pnd ncd dsk
lmd: tlh mkd tbx sqr nhs
jsh: dvl hrr ffz zlp
lmm: xkn hlh khr cpl tqv
vss: gjh gbn bsn crv
txz: xsn njd rtp kxt
qkb: vvq xqs tqf gvd
rjx: brt tkp rhk vvp
cbz: tvh dbc hvg qfr qbl
xkn: lmm dmn psx hmd
jkp: krs qts htk dfv
pfr: kvv xrz mtj gqz
dzf: vqd xbd rst dnv
rpt: cdb lzp bfr fqt dgt
hkl: rkv csd ztj psl
pvt: jlk plh rtp ncz
bbq: ngh crc xjr msg
mxs: qhh prt lhx jgf
mkn: rzl gtp rpm qrd
msg: bbq mjm qnd xmf gcm
skx: hcc lvf bqb pgs
jcc: tkd rvv zxl vxm
jft: qnt fbr hvx stv
bfh: tzm fqd tpm mlc
dmc: kbl mpd cqt pgs
dxh: pdk bfj pzk pct
xbj: tlp fpg phr bvx jtr cdc
nkr: kph tdt rrj mvh qbg tcm
gsb: lvf qqs rhb jbr
txm: bgs glj cdz pzl
nmp: lnc mmp zjj pvp
bpn: jqz sdp zrp fzm
thx: khr ltz dmn xpb
lrn: vmg nph kbr mdc
tnv: xlb qkx krf hdn llf
grq: qkg jhd ghp kzm
ggf: nfs jxv dvq hmh fkl gzf
mgv: xsr kzn kgb sdf
fkm: vmg kdf mzc stv
trq: hgr hfr sqc nzr
ljj: qzk qmq bbh hng fvz lzl
gzf: xcm ggf qzg tqp
xhk: rsp pqc psx qbp
zmd: lxb vkf pml dxp qzj
tvz: jpg xqj mlf thb xqf
vhl: nmr tfq pbx gvz
fdp: rgz fbq qpd dtp
gvk: rlt dmf dmn vkt
gtp: jtg cdg zxv dlr mkn pgz pzh
kxn: bmz jjc kkj lkr
kgc: bjg vcl djh pcl nms
lgb: krk vjd ssb xkj
vlx: xsr hgt sms ncd
sqp: fqm mcn tkp fnr
nmm: dvd pnp pzl qps prj
chz: xpq qxv hqh kpp
vcb: tqj lpp qgn tdg
zxf: ctn lmg xlp jjc lxb
jct: tms vnt lpp tzn pgs
hmk: kvh vvc bzp xfz drb
hlc: nxp xjq mxk qsh
jld: xkd rck vfp ckn
rcz: knx fvb gxf nxl jfz bhm
nkn: kng fqd njf rxp
qhf: zps rll ldr kts mkh
ffz: jsh dch fhv jjf
jcl: bnm xqn bfp qrd
bsh: pmj krf njd xqf zfn
pbx: vtt ftv vhl lpz
zvl: mds lvv tlz nph
ljs: ccb cgr jtr sxt
nfs: cmk jqr ggf nxl rdj jzx
dxn: kgm czg zps ccc lxz
tbx: lmd ldp jlk kmf dcq
lvk: kmz srf xzd bgg
cdg: jjf qhh gtp pvc
gfq: hlp fkv fjx cnx
nvl: cgz gcm vqv mzl kvl
ncg: mrz zqd nzx txc qfg
nvp: drc xrz tks kht
qhm: dlk jrl jzv lmg
jtl: cvn cnx fld ghs
pqr: fdq vfz fhk hml
sqr: xlz lmd rqf fhx xlb svh
kph: bfl zjz nkr crv pxl zsx
lzj: ssb vdh dch jlg
xbr: zgb bdk fpg hzf
sms: vlx lvh npx mvz
jhl: vmg clc npz mzc
rfn: bhl jmg zgr srm
vzb: lzc bbl gtb dcq
trp: mdc cbs tpm gfj njd
rjg: lmf lxn fkb bgs
vbl: qfr ccb zzt zxz
ccb: ljs lnp vbl fgn cdj lbn
rgz: hjp zpb fdp xfv
tzn: jct rck ckl jdq
srb: jth fvf lmg cmz
nhz: jzp fdf rpv tqn
ldp: jln tbx zxt bbl
dts: ggp npj dvs lzp
jdl: bql nzn xmm zrc
fht: rch ldr bhx cgt vtt
czg: vkx nxl prj dxn zcg hlv
lvv: gjf xhz bxd rsq zvl
kvq: xlp cmz vjf ndh
cnd: xgs dcd zlh zzp
gqv: zrq sxt fqv njd
hmr: vhz ttq tqm pzf
ljl: gkn lnp frj qjb
lmj: jqd nzn vvc djn
hng: srf ljj drc qjp
gqh: btl zcs trr vnj
mvh: bzp qvv pnx nkr
hbt: bgj nnc vpj kkr tcd
qdf: nhg bjj bct xsm
cvv: pct zqt plj cvk
lgz: pnx xgz dgl sgb sdj
rtp: tbq vqv pvt dtb txz sxr
nfr: cbj ktf mgt cfr
jnj: hmb fbl prj bft ccc
khr: lmm thx cgr tmd tsn
dlk: xmr rmp dxm rss qhm pnn
dtp: ztr blr fdp mtz xjf mpr
qpz: zjf hsq xxk lcq bvp dkf
jns: ljd ggz ldq fnr
jfl: gkq ccf mdg qrd
bsb: cpg lxc szh pcl
xqf: xnz rck bsh tvz nnc kmr
qkh: fnp trd zxz tzh
vmg: mfq jhl kjd fkm lrn bvx
lsr: hxp msn qnb mdb xjf
psx: kgq xkn cxn hjm xhk
qpd: hhl fdp jcv dgl
kzn: jch pbs mgv lrr
sjd: lmn mdb zlp zsx
vjc: zzp xvj mmf czs
bvl: sgt hqr hjt lrc
jph: xpx pvz mpr tmx
nhg: vtt tmz qdf jlt
rjs: fzj bgj sgj mqp
gmm: kvh ngp ckr cfd
mmv: jqm qrf knn ptl btr
zzk: gbn fkx jml xhv znh
btl: qqs xzz gqh ctx
pzf: fbl zbp hmr hlr mvd
gvg: djn mrc xrz dpc qsm
plj: nzx tcd cvv jtc
xzg: bms ckn kcc cdb tqv ftd
lxz: vgl dxn mpb jgd
jvq: khz ndb gvd hnl
qzg: qzl txk lgx gzf flr
pvc: tft jml dgl cdg
ntf: hqd btn nbj bsn msp
nsq: rfm hqh bfp fkx pxf
zxt: hcc tdm shm gzj ldp
hxb: ktf drc drg rlh
szh: bsb cjj knk lvf
tjc: ftd ggp bfr mvg
dpc: jzp gvg cct znh
kpd: kjj smn rsq rrc
zgb: hcd ndf zcx xbr
rhx: mmp xhx vfk zzg
tjr: ntz jgf kvv kpp rpv
bjg: jrf rkh xkd kgc zkk
qzj: jgf bkt vkf zmd
mvn: hzf btq tdk rxp
zqc: qjp clm cbj ndz
msn: zjz lsr lfp ckh flr
kft: jtz pjf mcz xlp
hrh: lpm xjg kvg mcz zlh
cdb: fnp rpt rdf mrb xzg
hhz: vgx xsr fkt zfq
rpd: rll rvv cbt gzv
mqp: zsr rrc thm rjs
jbp: dcl nlh tqm hjn
lrc: nmq rxc xmm xff mhr bvl
xgs: cnd nbt vnp bqm zlh
sqm: lbn jmx rfk gfj
xrh: lxc pbq fdq tth drf
gdh: lkf vxn khz cgs
pqf: khk rft cch tzh
ztx: xqj szj rfk mns
cbt: dtf vkz rpd jdp
sjv: bbg gtq dhg fnn jtp lxp
zzl: hfd qsd njd zcf flb
ftr: zzp vkx hqz pxf
kkf: pxf ssj nzn qzx
szj: ztx sxt nnc bjj
lcq: qpz ftv svv tmz
nmq: lrc pqx qzl dfv
gmv: cpg sqc rzn prc zcs
cdl: dnb dch cxg rdg
hcd: zgb vlz qqr sls
kkl: jcv hbc zms zrp
zlh: xgs dvr cnd hrh msb
mdh: kzr rch sln dlr
nmr: trd vhl fbr mdc
ngh: zfj glg bbq xmt
kbr: bbg qtx lrn pbd vkt
pgz: gtp tpg jxj sgk
lbp: hgj rkq hcz srf
cdk: rmr qzl gkq jzv
qpg: jhq vbv pst cbb
qxq: tms zfs jpg svh
zrj: jsm rms nlr mvg tqs qnc
xrj: tsj txg dvr lvl ttq
jbs: qcl hpr rfk vnj
smf: jhv lvp tqv pmj
msb: xtj jqc mqh zlh
hxk: pdk vfd jck jdq
qsx: pvd rbn ndf vxv frj zfn
ccj: gvd ncf jjc rzq fpz vhx
pkf: fqh nnx zfj gsd
jxs: zrp kzj mmp vkf
nbt: xgs hxp vtr zpr sxf kms
qzv: qvj xnv hjt hqv
khk: pqf xjq bgz knn brt
rfk: sqm jbs ztx cqd
cbs: sfg zhl trp vnj
tlz: pxk bbl qqr zvl
xjg: vfk hrh zlt fnl
zfn: hgr qsx hxs bsh mnh
jqz: bpn jpt hsb mvd
xmm: jdl lrc mlb gts
lhf: cgn vgh kbj vnf tqp
khz: dvd gdh nbj jvq
qhh: cdg mxs tzk xnj
nzb: xlp qlx qng pkm vvq
vxm: jcc gdx fvg btn rsf
zfk: lxc sqc tmv xrt
vxv: bkh ltb qsx lzg
bzc: tms dtr trd ztk xrm
mjk: tvg jjf lkf kfm fkf
dfv: rrh nmq drc sfk jkp
cpg: gmv nxp pgs bsb
dxm: rtf dlk ndb tbm
xhv: fvb zzk lrp znh
cjj: szh ktb kbc tsn pbs hhq
tns: gdg nph ndf tpm fzj txc
rmq: kch pxf mpl pmq xvj
jbx: plz cdm ntz lmh
drb: hjn hmk xnq bsc zxj zpb
srf: gxf hng lvk bsc lbp
rtg: zrz rzd zlt lvs
vqc: vvx btn jvp hdz
rdj: zrp zds fkl pjf nfs
dlr: gtp jxj xjf mdh
hgj: lbp dnz qts fhs
fbr: nmr jln fzj jft hnn xpb
hmh: fsn ggf rxc jxg
jjh: qqr lmk xbv zts ghq tvh
zlt: glk rtg xjg kmq
dcn: tsf qng nrg qsm
mzc: lvf gcm qcl jhl fkm
jbr: rsm gsb pvd jch
qxn: rdf mlc jsx pxc
glj: dvr kmm lfl txm
gxf: cmk srf rcz xzm
vjd: vcz pqs zsx qzx lgb xkj
svv: tjq sfg kjj lsf cdc lcq
hcm: fkx fkf sss czh
fpg: xnz xbj pst xbr zvt
kht: nvp brb jpt ckp qvj
pdc: qbs lcs jrs cnz
ghf: gdd ngm cgr kcp nnh
hbc: hhl zms kkl jxf tvg vjf
ttc: vmt mzt zsr ncz
kgg: czc cxg xfz lmh
fkb: dqg vpv jnd rjg
bsn: vss kgj ntf bhm
qkx: lzr lfq xqt tnv
ndl: tth vmd tbq mzm
ssk: xmq bkm lkc txk
lvl: qlx kxz xrj bgs
bbg: nzn sjv lfh kbr gtq ndh
pct: hhq zxz cvv kvn cqt dxh
rvv: gtq rpd jcc qld fdf
lnp: ccb ljl dpk tvh
rfj: vvx jxv kzt blr xzm
gdd: ghf lvp kmj hzp
tcm: vvc tzk nrg nkr
sqc: tmv gmv trq zfk rxp qjb
fhk: dkd pqr fqv tmz zkv
vfq: llk shl kgn vbv
rsm: jsm dmf vgx jbr
ldr: fht xpq cxm qhf
pnd: qcl tzm mrb dkj
lkc: ghp ssj ssk jtk
vqv: fzk rtp nvl zcp
dzd: jnd dcl llq hgz sgk
lfh: ndn bbg mdb zcv
qbx: bjj cbb tkp qcx
dvs: kjj dts ngk cvj
zvp: zbg tth ftx vkt
vgx: hhz qgn rsm nfn lzp
cnc: llk nrd nnx gkh
pxl: ntv fzm kph gzv
mpl: rmq qmb zls jgf bgb
lpd: ndz xmq zlp lqs
pjd: jdj xrz xtc hnh
jbz: qjn jrl bgh pml
zlb: plz xpx ntz xlh sgb
ngm: xxm lmq ghf zvt
znh: vfk xhv zzk dpc
tbm: hxp fjr jzv tkh dxm
lvp: gkj smf gdd jmx
bgb: tqm kch mmc mpl
jzx: xhd nfs zfd dqh
jxf: vlh jqd hbc pnp
ggp: mrz pst vhv dqd dts rsp tjc
hfr: vll trq bkv dbg
zqd: tmd xch ncg nnh
jth: tks srb brb prj
vmv: jkq ttk tzm tvh
kcc: vmf qsh fzj xzg
dvl: jsh pcv fsn gbt
ltm: jtz rmr fnn mrm
tsx: ftd ggz pvd vqh
sbl: xqs lmn bdb hrr
lnc: nmp tqm nmj fvh kkj
jgn: hml ckn jxt lzg
rnl: pdk gsd vqh tmd dbs
rjm: svp jdp pzh qrd
cgr: ghf khr ljs zzt
zzp: vjc nxz ftr cnd
rzl: mkn krs djr pvz
dqh: vhz jzx lbl bkz
qmk: zgr jkq nzk zdl vpj
dtc: ztj mxk bgj lrz
bnm: dqg flr gjh jcl
gpt: hjz nqp fgd tbq
zfq: qjb hhz sqq vrv
xlz: sqr vlt xzv svh
drc: nvp hxb jhd hng dfv vls
zpr: spk nbt cdm mrm
vvc: gtr tcm hmk lmj
flr: xnv kvv bnm qzg msn
dqm: gkz jtg qjn xtr mts
thm: xkg xkd krq qxt cdc mqp
fhv: ffz hfc gzv ntb
vxn: rkq ssb gdh qlg
sdj: snt clm lgz hsp
rll: rpd pkm qhf jrz
dcq: cqt vzb jkq tbx
xqt: vmf qkx tcz gkl
djh: rrn zkm nxn kgc
rdn: sld jpp vlt fgn xrt
qcl: jbs pnd dqd mzc
ghg: zhj ndb rcx mmc
hhq: pbd pbq pct cjj
hvg: dhr qqv tpm cbz
btr: xsn zrq xrm dnv plx mmv
tdm: mvg bbn hdn llk bfj zxt
gzm: xcm xqn vnp cfd
bkt: qzj sml bgg lvs
kds: prc hpr zzt sqq
hjm: qnd zbg dkj psx
mtz: czs dtp zcg dcl
hgz: kmm fvz lxn dzd
fdf: jqc jxv nhz rvv
jcv: qpd qjn kkl pqs
nxl: czg nfs rcz hrr dxt
kzt: rrh rfj ldg bfv fnl
kqz: tkd rfv qkg dhg qjp
cqd: bqb pqc jkq rfk jpg
dnv: vjv btr dzf bct
cnz: jgf dxp bpj pdc
gkj: nxj lvp jgj fhq
vcl: gcp tmz jjd kgc
bql: bqm jdl ngp hfc xsh
qnt: xnz jft gkn pjn
rnz: djn lmg xtc lqs fns vtk
mpb: lkd srz txk lxz
gtq: qsm rvv sjv bbg
jlt: hzf svh fbm nhg fkr
dmn: xkn gvk dkb thx mzm
llq: pgr fbq pzl bfx dzd
gbt: rrm dvl lmf jsl
bsc: lvs nxz srf vgs drb
kgb: ljz vlt xsr mgv tpm ftx
jhd: drc grq kgd mqh prt
jgj: rkp gkj tjq dkj
hrr: jsh hdm gfs nxl sbl jxg
fvb: rcz xhv czc jfd
vvx: rfj vqc qkg bgg
xnv: flr jkr qzv dqg
ztr: lsm dtp rcx qjp
drf: kdd xrh mzl jtc bpp
fhq: xxv dkb qrf gkj
nrd: tlh jlk cnc sdf
vtn: npj qsd bjz qnq
dlb: xlt pln fpz rzd
knx: rcz xdj xtj dnz
pgs: cpg jct dmc fbp skx
zsp: hsb scj xtc rbs
mlv: bhl brt sdv bmv
thp: vqd zcf zqj kmf jsx
lmg: zxf qhm rnz ccf srb
htk: spn jkp mhr ztg
bdc: gvt knv kgn xpl
jqm: mmv ptl zdl zjf
kng: nkn fzx fqh kjd gzj
mds: rjt qnc zvl tcd
cvj: lxc pxk dvs csr
xrg: xql jxj czh pgr
zcs: gqh kjd tcd ztk gmv rxp
cgz: xxn svl vqd nvl
rmp: ndz tqn gbn hjn dlk
fjx: qrj jfd prm gfq
cnx: jtl jrs dhg gfq hdz
jqd: ggh nhc ljm lmj mqh jxf pnp rlh fvf
jkq: pvd vmv qmk dcq cqd
qnd: sdn hmd msg hjm
ctx: sdn bdk rfc xmf btl
lmf: rjg xrz qhp gbt
rst: vfd dzf xrt qjc pzn
fkt: hhz fqv mpd fqt
gkq: mrc cdk jfl djn xmq
qzk: ljj vlh fnl lhz
spn: xnq lhz htk nrg
mrz: ggp mjr ncg mkz lpp
sdg: dnz tdt hsp cfd hnh
rpm: cbx mkn npt xdc
sgb: lgz vnp zlb qvv
jvp: vqc crk dpv bbh
bmv: ptj knv qcx mlv
lmh: jbx kgg jqc kbj
lxb: zmd zxf mlb qmq
tms: qxq jct cxl ncd bzc
zhj: jrs rxc cgt vgs ghg
xbd: rjz thc sjg jhv dzf
zkk: nzk vqd qnc dmf bjg
prm: vdh kkj fjx nmj
hjn: rmp drb jdp jbp
svp: knj pnx rsl rjm
nzr: fnp trq hsq xrm
rfb: fvf bpj rcx xtr mvd
rkh: bqs bjg ghh lmr xrt
kxz: xpx nnk qkg lvl
ktf: hxb jgd hvp nfr
tmd: zqd rnl jtd khr
mmc: hqz bgb xdj txk ghg
xql: gkz xfv xrg cjs
dvd: nmm khz fnl hqz
fxt: xjr dkb fxm xxv
tvh: lnp jjh cbz vmv
fqt: xxn fkt cxn rkp rpt
jqc: fdf msb lxp lmh
tfs: zqz sln kzj tfk
qbp: pzn vfd zhv xhk
ztk: ccr bzc zcs pbs dtb
vqd: thp dzf cgz zkk
vfz: kxt ftv pqr pqc jfn
vnp: xgs lmz gzm dxt sgb
hlh: lmm mzt mcn zhv fqv
zcf: pgp txc thp zzl
tlx: kdz dtr mqr vkb fnr
kpp: thn mgt bhx chz tjr
bfx: lzl llq cdm ndz
gzv: nrg ndn pxl fhv vqn rpd
kzm: cxg gdx grq tmx
ngk: nnc hsg zjf dvs
vlh: qzk snt qps tpc jxf
ntz: jbx tjr zlb mhr
qtx: rzh kbr tfq svs pxc
pdd: vst shl tzz lzg xsr
rsq: xsn hfd nrt lvv kpd
qps: dkp nmm knj vlh
rlt: fks gvk fgn cch
hcz: xtr xnk xvj lbp
tbq: ndl gpt rtp prc vlz
kch: pqx rmq bgb xnk
pmg: hxp zzg hdm fqr xtj gdx drr zpb
xtc: rnz bkm pjd zsp
gqn: xnd fvh brb jxg
kbl: dmc phr mdc kmf pbs
mkz: mrz dbc hfx lzp
rsl: jlg svp xvh npt
sdf: mgv nrd cdc tth
hpr: kll jbs kds pxc
bkm: rfv nnk rmr ssk mpn xtc
xzm: gxf zsx xzd rfj
vvq: qkb dxp nzb xnb
rxp: nkn sqc zcs mvn
dcl: dzd qlx mtz jbp
jsx: tzz thp rft qxn
qfg: lfq sxt ncg ftd
xcx: tth jrf jbh zxz
xlb: kjj tnv sqr jxt
sjg: cbb xbd kbc qfr
tft: ggh fkf pvc xqn
vmd: pzk ndl kjj ghh tps
fkr: jlt tps rck hfx
snt: vlh rrm sdj mrm rbs
pbs: kzn kbl ztk cjj
bfj: khn tdm sfg dxh
xvj: vjc zlp hcz vff rmq fkv
plh: pvt mzt zqt xrt
btk: fld nnk mts hch
nfn: jqx jjn vgx npz
gkl: hsq ftv xqt stv